00000000000000000000000000000000000000000000000000
00000000000000000000000000000000000000000000000000
00000000000000000000010101010100000000000000000000
00000000000000000000010104000100000000000000000000
00000000000000000000010000000100000000000000000000
00000000000000000000010000000100000000000000000000
00000000000000000000010000000100000000000000000000
00000000000000000000010000000100000000000000000000
00000000000000000000010000000100000000000000000000
00000000000000000000010000000100000000000000000000
00000101010101010101010100000101010101010101010000
00000100000000000000010000000000000000000000010000
00000106000000000000000000000000000000000008010000
00000101000000000001010505050101000000000001010000
00000101010101010101010505050101010101010101010000
00000000000000000000010505050100000000000000000000
00000000000000000000010707070100000000000000000000
00000000000000000000010707070100000000000000000000
00000000000000000000010909090100000000000000000000
00000000000000000000010909090100000000000000000000
00000000000000000000010909090100000000000000000000
00000000000000000000010003000100000000000000000000
00000000000000000000010101010100000000000000000000
00000000000000000000000000000000000000000000000000
00000000000000000000000000000000000000000000000000
1212
1
1
1
 Press 'R' to Restart