02000000000000000000000000000000000000000000000102
00010000000000000000000000000000000000000000000001
00000000000000000000000000000000000000000000000000
00000001010101010101010101010101010101010101000000
00000001020000000000000000000000000000000101000000
00000001000000000000000000000000000000000001000000
00000001000001000000000000000000000001000001000000
00000001000000010101010101010101010100000001000000
00000001000000010100000000010200000100000001000000
00000001000000010000010000000000000100000001000000
00000001000000010002000000000001000100000001000000
00000001010000010000000000000000000000000101000000
00000001000000010000000201000000020100000001000000
00000001000001010001000000000000000100000001000000
00000000000000010000000000000000000100000001000000
02000101000000010000000000020100000100000001000000
00000001000000010200000000010000000100000001000000
00000001000003010101010101010101010100000001000000
00000001000001000000000001000000000001000001000000
00000001000000000001000000000000000000010001000000
00000001010000000000000000010000000000000101000000
00000001010101010101010101010101010100010101000000
00000000000000000000000000000000000000000000000001
01000000000000000000000000000000000000000000000000
02010000000000000000000000000000000001000000000002
1116
1
1
1
Lava!