00000000000000000000000000000000000000000000000000
00000000000000000000000000000000000000000000000000
00000000000000000000000000000000000000000000000000
00000000000000000000000000000000000000000000000000
00000000010101010101010101010101010101010100000000
00000000010900000000000000000009000000000100000000
00000000010000000000000000000000000000000100000000
00000000010000000009000007000005000000090100000000
00000000010000070000000503090000000000070100000000
00000000010007090700000000000000000900000100000000
00000000010000070000000700000700000000000100000000
00000000010500000000000000000000000000000100000000
00000000010000000400000000000900060000000100000000
00000000010900000000000000000000000009000100000000
00000000010000000000000000000000000700000100000000
00000000010000000000000000000005000000000100000000
00000000010500000000000008000000000000000100000000
00000000010000000005000000000000000000070100000000
00000000010000000000000000000000000500000100000000
00000000010000070000000709000500000000000100000000
00000000010101010101010101010101010101010100000000
00000000000000000000000000000000000000000000000000
00000000000000000000000000000000000000000000000000
00000000000000000000000000000000000000000000000000
00000000000000000000000000000000000000000000000000
1212
0
0
0
I am confused!