00000000000000000000000000000000000000000000000000
00060600000000000000000000000000000000000000060600
00060000000101010101010101010101010101010000000600
00000000000100000000000010000000000000010000000000
00000000000100010101010101010101010100010000000000
00000000000100010202020202020202020100010000000000
00000000000100010101010101010101010100010000000000
00000000000100000000000011000000000000010000000000
00000000000101010101010101010101010101010000000000
00000000000000000000000000000000000000000000000000
00000000000000000000000000000000000000000000000000
00000000000101010101010101010101010101010000000000
00000000000100000000000010000000000003010000000000
00000000000101010101010101010101010101010000000000
00000000000000000000000000000000000000000000000000
00000000000000000000000000000000000000000000000000
00000000000101010101010101010101010101010000000000
00000000000100000000000000000000000000010000000000
00000000000100010101010101010101010100010000000000
00000000000100010202020202020202020100010000000000
00000000000100010101010101010101010100010000000000
00000000000100000000000011000000000000010000000000
00060000000101010101010101010101010101010000000600
00060600000000000000000000000000000000000000060600
00000000000000000000000000000000000000000000000000
0612
1
1
1
Teleporters!