01010000000500000000000000000900000000000700010705
01000000000000000000000000000000000700000000010907
00000000000000000000070000000000000000000000000101
00000002020101010101010101010101010101010211000000
00000002100000000000000000000000000000000502000000
00000001000608000000000000000000000000000401000000
00000001000000000000000200010000020000000001000000
00000001000100010101020101010201010101000001000000
00000901000000010200000700090000110100000001000500
00000001000000010000000000000000000100000001000200
00000001000000020000000000000000000200000001000000
00000001000000010900000909070000070102000001000000
00000001000000010000000903070000000102000001000000
00000001000000010700000907070000090100000001000700
00000001000000020000000000000000000200000001000900
00090001000200010000000000000000000101000001000000
00000001000000010200000900070000020100000001000000
00070001000000010101020101010201010100000001000900
00000001000000010000000200010000010200000001000000
00000001000100000000000000000000000000000001000000
00000001000000000000000000000000000000000501000007
00000001010101010101010101010101010101010101070000
00050000050000000001000000000009000000000000000002
00000100000000000000000000000000000007000000050000
09000000000500001000000000000000000000000000000009
0101
0
0
0
Literally Impossible